%%%%%%%%%%%%%%%%%%%%%
% . ............. . %
% ... ... ... %.  ..%
%... %....%..%.... .%
%.....%.% ..... ... %
%...%.. ..%.%.......%
% ..   .%.. ......%.%
%....G. %..... ... .%
% %..P... .....%....%
%%.......  ... %. ..%
%...%.  ..%... ..%. %
%.%.................%
%. . . . . . .......%
%...%  ... .%. . . .%
% . .%..%..%.. . . .%
% %..... ... ..   ..%
%.. .. ....   ...%..%
% ...  .. .G . % ...%
%.% ..............%.%
%%%%%%%%%%%%%%%%%%%%%
