%%%%%%%%%%%%%%%%%%%%%%%%%%%%%%%%
%...... .%............. ..... .%
%....... %......... %... ......%
%.... %..... %... .. ....  ... %
% %............  .   ..%.... ..%
%.%. ........ .. %...G....  ...%
%....... ....%......... ..... .%
%... ..........%.....%...... ..%
%%....  %. ... ... .. ...%.....%
%  . .....G..%.......P......  .%
%.. ..... ...%..%... ..... ....%
%%%%%%%%%%%%%%%%%%%%%%%%%%%%%%%%
