%%%%%%%%%%%%%%%%%%%%%%%%%%%%%%%%%%
%.. ..  .... . .......... . .. ..%
%  .  %........%. .%..... ...%. .%
%.%.%. .. .. ..  ... .. .. .   ..%
%.   ..... .%   .......... .. .  %
%. .   .... .  .   . . . .    ...%
%....  .  ... ...  .. ..  ...... %
%.. ..%.. .  % .  ...... %. . .. %
% ...  . .... . .. . . ....... ..%
% ..  ... .. .. . .. ...  . ..  %%
%..  . . .    . . ... .... .. .. %
%.   .. . .     .....   .. .  ...%
% .    ...... ... . . ..  ... ...%
%.    .  .....  ......  ...%  . .%
% .....% . % ....... ..    G.... %
%...%..      . ... .... ......  .%
%.     .. ..%  ......... .%..... %
%. %  ...... ...  . ...... %.....%
%      %..% .   %. .... ... ..P. %
%%%%%%%%%%%%%%%%%%%%%%%%%%%%%%%%%%
