%%%%%%%%%%%%%%%%%%%%%%%%%%%%%%%%%%%
%.  ..% ...%..  .... . .. G.... %.%
% ..... . %. ..... %...   .%. .. .%
% .    % ........... ......%......%
%.......% . .. .. %% . ... .......%
%.. . .....   % . ... ...G..  ....%
%. ....... .% ..... . .... ..%... %
%..  ...%... %..... . ... .  . .. %
%% ... . ....% .     .......... P.%
%.. .    ...G.. .  .............. %
%%%%%%%%%%%%%%%%%%%%%%%%%%%%%%%%%%%
