%%%%%%%%%%%%%%%%%%%%
%... ... %.....  .%%
%..... %..  ... ...%
%. ... .. . . .....%
% .. ...% ....... .%
%. .%    .  ..... .%
%  ....%.  . .% . .%
%........ .. ...%..%
%..% . ....... ....%
%.% .% . .   ......%
%% .%..  ... G....%%
%..... %....  .. ..%
%% .G.   ... %. % .%
%..%.  . . .......%%
%..%. ... .%%.....%%
%.   .P..%. ... .. %
%%%%%%%%%%%%%%%%%%%%
