%%%%%%%%%%%%%%%%%%%%%%%%%%%%%%%%%
%.  ..... . . ... .. ..........%%
%......... .................  . %
%...  .... . .... .. .... .. ...%
%...  .%..... .. ....  .........%
%........  ... . ............ . %
%  ........    .. .. ......  ...%
%...  ..... ..............%. ...%
%...... ..... .  . ....... .. ..%
%.  ..%...  .. % . ..  .........%
%........ .  ............... ...%
%...  . .........P %....... .%.%%
%..... ....... .... ... .... . .%
%...   ...... . ......... ......%
%.. ...  . ........ .... .. .G..%
%.. G ...... ... . . ...........%
%.. . .... ..   .. .... ...%... %
%...   ... ......... .... % . ..%
%. ....  .....................%.%
%%%%%%%%%%%%%%%%%%%%%%%%%%%%%%%%%
