%%%%%%%%%%%%%%%%%%%%%%%%%%%%%
%. .. .. . .     . %%.. . ..%
%.%.....%.....%...   ...... %
%... .....%..........  . ...%
% . ........ ....% ... .....%
% .... ..%.. ..... ..... .. %
%.... . .G......... .....P..%
%... .. ...... ..... .. ....%
%. ...%.  .............%% . %
%.. .. ........ .  ..%.%   %%
%...... .....%....G.... .. .%
%... %. ......%% .. .%......%
%%%%%%%%%%%%%%%%%%%%%%%%%%%%%
