%%%%%%%%%%%%%%%%%%%%
%.....P . %....... %
%....  ...  . ...%.%
%  ........... . .%%
%.   .. ..... ... .%
%. . ......  % ....%
%. ... ....%.... . %
%......... .. . .. %
%...%.....G....%...%
%... ....  . .. ...%
%..  %..%.. .%.  ..%
% .. ....%...%.. . %
%  ..... ..........%
%  .. ..%. ....G   %
%%%%%%%%%%%%%%%%%%%%
