%%%%%%%%%%%%%%%%%%%%%
%..%. ..............%
%.........  G..  . .%
%.....%..... .... % %
%...... ......... ..%
%......%... ..... ..%
%... %....... . ....%
%....%........... %.%
% ........%%....%...%
%.%..... ...... ... %
%..%.   ... .... ...%
%......%.......%.. .%
%  ....%..  P..%....%
% .. ..%.........%..%
%..... ....%........%
%..%. . ..% .. ....%%
%..... .......... ..%
%.. ... .%...... ...%
%%%%%%%%%%%%%%%%%%%%%
