%%%%%%%%%%%%%%%%%%%%%%%%%
%.%.......... .   %%.%..%
%...%% .%... ..... .. ..%
%.....%...%.% . ........%
%%...... ....% %.%. ....%
% . ..%.......% .. ...%%%
% ..  ...... %...... ...%
% ...%.. %.G ... .%% ...%
%... %%..... ..GG.%...  %
%...G.%P..%.. ..........%
%%%%%%%%%%%%%%%%%%%%%%%%%
