%%%%%%%%%%%%%%%%%%%%%%%%%%%
% .........%. ... .%.. ...%
%.........% . ....%.... %.%
%..%................  ....%
%G.....%...%... ..........%
%...........%.............%
%...... ...%... .... %. .%%
%... . .... .....  P%... .%
%...%....%.  .....%%... ..%
%%%%%%%%%%%%%%%%%%%%%%%%%%%
