%%%%%%%%%%%%%%%%%%%%%
%.. %......%........%
% .... .....%.% ....%
%.......  ....%.  ..%
%.%.. .%% ..........%
%........%. .... ...%
%.... ....%.%  ..   %
%.. %... ...... . .%%
% ...... ....  ...G.%
%.   . .  ..  .. ..%%
% ...... .... ....%%%
%  ... ....% ....  .%
%. .%. ..  . .%.. ..%
%...%... ...... . % %
%.P. %. ...%   .. . %
%%%%%%%%%%%%%%%%%%%%%
