%%%%%%%%%%%%%%%%%%%%%%%%%%%%%%%%%
% ......... ....... ......... %.%
%. . . .%.. ......G...    .   . %
% . ....  .. %.... . . ....    .%
% ..... .% ....... .   %. .... .%
%.. ... . .... ... ...... . % ..%
%G....  .... % ..... . . P.  .. %
% .   ..% .%. . .... .... .  %..%
%..... . ... . . ... .  .. .....%
%..  ..G .. .   ... .  ... ... .%
%..   .. .. % .....  .. ..  .  .%
%. %... .. .% ........ ... .....%
%....%.........  .   ........  .%
%%%%%%%%%%%%%%%%%%%%%%%%%%%%%%%%%
