%%%%%%%%%%%%%%%%%%%%%%%%%%%%%
%...%.. ..  .. ... .. . ....%
%. .... . ...... . .%. . .%.%
% . . . ......... ....  . ..%
%.. P.. .  . . .. ........%.%
%.. .......%.. .% .... . ...%
%. .... .  ....  .%   .. ...%
% .......... ..%.....  .% ..%
%.. ...  .  . ........  ....%
%. ..... ...... . .... ...%.%
%.. ..G... ... .....  . ....%
%......... .....%. .. ......%
% .. ... .... ...  % . . .. %
%....... ... .. . .. ..%....%
%.  . .......   . ... .... .%
%.. ..... .. ...............%
%  ...... ..... .. ..G. .. .%
%%%%%%%%%%%%%%%%%%%%%%%%%%%%%
