%%%%%%%%%%%%%%%%%%%%%%%%%%
%..   .. ..%...%.  ......%
%............... .. . ...%
%.. .. .... . .. . ... ..%
% . ...... ......... ....%
%. .  .....% ...... ... .%
%  ......  . ..   . .....%
%.. ..%........ .. ... . %
%... .. ...........P. .. %
% . ...  . ... ....  .. .%
%. %.. ........ ..... ...%
%...... .  . ...... ...  %
%....G.. .. . .......%.. %
%%....... ... ...%. .... %
%..... %..... ..... ....%%
%...........  .... .. ...%
%.. ...  .. .  .   ... ..%
%. .... ... ....  .. ... %
%.  ... . .  . .... . ...%
%%%%%%%%%%%%%%%%%%%%%%%%%%
