%%%%%%%%%%%%%%%%%%%%%%%%%%%
%...%. .%....... .........%
%.... ..%.... . .... ..  .%
%..   ...%. ..............%
%.P ..... .. .. ......... %
%.....  ........%...G..  .%
% ....... .. .. . .. .....%
%. ... .....  . .... .... %
%...  .%. %........   .. .%
%....%.  . .. ..... ..% ..%
%.......  .. ..... .......%
%.  ......% ........ ... .%
%........% ....... .... . %
%...  ... .. ...%..G...   %
%... .....  ....   ..... .%
%. ...........% % .. .. ..%
%............... %... .% .%
%...... ..........%.......%
%.. ......%.... ........  %
%%%%%%%%%%%%%%%%%%%%%%%%%%%
