%%%%%%%%%%%%%%%%%%%%%%%%%%%%%
%...........%...G.%... ..  .%
%. %.... %.. ....%...  .....%
%..... ... %...%......... ..%
%......... ...... %.%.. . .P%
%  .... ...  .. . .... .....%
%....%...%..... . .. ..... .%
%  . . .. ..................%
%.. .......%.. . .....  .. .%
%........%... .G... %.  ....%
%%%%%%%%%%%%%%%%%%%%%%%%%%%%%
