%%%%%%%%%%%%%%%%%%%%%%%%%%%%%%%
%...%.......................%.%
%..... .....   ...%. ... ..%. %
%.% .. .....%..%..............%
%%.. ........ ... ..  ..%. .%.%
%..%.... %..  ........ .......%
%.... .......%. .G.. .........%
%. . .....  ... ........ . ...%
% %.......%. ..........G.. ..%%
%.. ........... ....   .......%
%. .  %..%.. ........%....%...%
%.............. .... .... ....%
%.......%...%..... .. ..   .  %
%...  . % . .P....%...........%
%%%%%%%%%%%%%%%%%%%%%%%%%%%%%%%
