%%%%%%%%%%%%%%%%%%%%%%%%
%....%........ % ..... %
%.....% .   ....% . ...%
%G  ...  .... . . .%...%
%...   .G. %.    ... % %
% P......   .. .  .. %%%
% ....... . . ... . .. %
%....  %...  ..... . ..%
%  ....%..%. ..... ..  %
%    .  %. ... .... .  %
% ...  ..   ... ...   .%
% .%..% . .  . ...... .%
% .....  .  % . ....  .%
%. ... ..%%..%. ..... .%
%....  . .. . ..  ... .%
%.  ....  ..  . .......%
%  .  .. %.... .. .%..%%
%. .. ............... .%
%..%.  % .......%... ..%
%%%%%%%%%%%%%%%%%%%%%%%%
