%%%%%%%%%%%%%%%%%%%%%%%%%%%%%%%%
%..%....%.. ... .. .  . ..% ...%
%.... ... .  .  ....... ..... .%
%..... .....%. ...... . .....%%%
%......... ....%........G%... .%
%.. . ..% ..  ....%....... ....%
% .....% ... ... .. .  ... ..%.%
%.%. .....  ...... ......%.....%
%..  ....%........ ..  G.....  %
%.%. . ...P.....  . .....% ....%
%  . ... %.  .....G.. .  ...%..%
%.. %.. ......% .. .%..........%
%... . ..   .. ...... ..... ...%
%. .  ....... ...  .....%%. . .%
%.....  ...%%% .... .. ..%  .  %
%%%%%%%%%%%%%%%%%%%%%%%%%%%%%%%%
