%%%%%%%%%%%%%%%%%%%%
%...............o..%
%....%.%..%........%
%%%.%o..%..%%...%..%
%.o..........%o....%
%..%%....%.........%
%....%.........%...%
%.%.%....o.%%G.....%
%%...oP.%......%o%.%
%..%%.........%....%
%.%..o%.....%...%o.%
%%o%...o..%..G.%...%
%...o.%.......%....%
%......%.o%o.o...%.%
%....%%.......%%%..%
%.......%...%....%.%
%%%%%%%%%%%%%%%%%%%%
%%%%%%%%%%%%%%%%%%%%
%...............o..%
%....%.%..%........%
%%%.%o..%..%%...%..%
%.o..........%o....%
%..%%....%.........%
%...%%.........%...%
%%%.%....o.%%G.....%
%%...oP.%......%o%.%
%..%%.........%....%
%%%..o%.....%...%o.%
%%o%...o..%..G.%...%
%...o.%.......%....%
%.....%%.o%o.o...%.%
%....%%.......%%%..%
%.......%...%...%%%%
%%%%%%%%%%%%%%%%%%%%
