%%%%%%%%%%%%%%%%%%%%%%%
%..% . .%. % .....%...%
%.....%... ..... %... %
%..... ...%........  .%
%...%..  ........ .  %%
%..  ....   . ......%.%
%.%.......  .....  ..%%
%. G   ....  .  ...%..%
%. .......... %. ..P..%
%.%....   . ........ .%
%..... ..%.%... . .. G%
%.%.%  . .%...%....%..%
%..G ... ...%...... ..%
%. ..... .. .. .. . ..%
% ....  . ...%%...% ..%
%%%%%%%%%%%%%%%%%%%%%%%
