%%%%%%%%%%%%%%%%%%%%%%%%%%%%%%%%%%
%.. %..    %... . G. ....%.. ... %
%...%.. .  ...  ....... .........%
%..G%   .% ...%.....  .%....... .%
%...    ...  . ..... ...... .. .%%
%. .  .. .... . ............. .. %
%..... ..... ...... %. . ...%.. .%
%%.... .....%%. ... %.   ....  ..%
%.....   ..%........ %..% ....%..%
%.. ......... .. .. . .. .G..... %
%.%...  .. ........... ...% %....%
% .. .. .%. %...%....  . . ..... %
%... .    . ..... %..... .....  .%
% ...%........ ........... ......%
%..  ... ........P........  .....%
%%%%%%%%%%%%%%%%%%%%%%%%%%%%%%%%%%
