%%%%%%%%%%%%%%%%%%%%%
% .....%.G...%%. . .%
%%..........  .....%%
%.... %%..%...%%..%.%
%.. .... ........%..%
%. ...% %%..P.......%
%..%.......%........%
%............  .....%
%.%. ....... ......%%
%%%%%%%%%%%%%%%%%%%%%
