%%%%%%%%%%%%%%%%%%%%%%%%%%%
%. .................%. ...%
%..... ... ..... ... ..P..%
%........... .  ..........%
%   ......................%
%. .......  ...   %. ... .%
% ...%....  ..... .%.. ...%
%. .... .%  . .. . ..... .%
%...............  .. ... .%
% .. .. .....%. ... ......%
%. . ............. ......%%
% ... .. .. ............ .%
%... .. . ..  .   ........%
%.. . ....................%
%... ....%..  ............%
%.%...... .. ...... . ....%
%.%. ..  . ..%............%
%.... G...... .. .  .... .%
%%%%%%%%%%%%%%%%%%%%%%%%%%%
