%%%%%%%%%%%%%%%%%%%%%%%%%%%%%%
%..... %.%......  ..... .. ..%
%.... ...G.........   ...%...%
%. . .. .... .. ....%...  ...%
%.%.%.....   ....... .. . ...%
%.%....  ...%.... . ....%... %
%.  ..  .. . .. .%.....P .. .%
%  %%. .. .. . ... ... . %...%
% .. G . .....%  ..  . ...%..%
%.. ............%..  ........%
% . . .....  ..%..%.  ... ...%
%%. ....%.. .......%...    ..%
%.....   .%.. . ... .........%
%    ... .. ........ .. .....%
%%%%%%%%%%%%%%%%%%%%%%%%%%%%%%
