%%%%%%%%%%%%%%%%%%%%%%%%%%%%%%%%
%....%...% .... ...  %  . ..P..%
% ...... .. %...%..   . . %.. .%
%..  .  ..%..  ... .. .. .  .. %
%. ...... .%.%....... ..... .  %
% ..% .. ... .........  .......%
%.... .   .....  ...  ..  . .. %
%. ...... .....%. %.%.......   %
% .. .. ......%  .......%.%....%
%.   .. .G....  . . ...%.. ... %
%%%%%%%%%%%%%%%%%%%%%%%%%%%%%%%%
