%%%%%%%%%%%%%%%%%%%%%%%%%%
%  .. % ...%.. ........ .%
%. ..........%.......%...%
% . .  ...%. . ........ .%
%....  . . . ....% . ....%
%.... . .   .....P..... .%
%. .. ... ... .....  ....%
%.  ...... . ...  . .... %
% %..% ...%........... ..%
%..%.. . .. . ....... .. %
%  . G..... ..  ..    ...%
%%%%%%%%%%%%%%%%%%%%%%%%%%
