%%%%%%%%%%%%%%%%%%%%%%
%.. ...   .... ......%
%.. ... .......%.....%
%  %....... ....%. ..%
%...... ...... ...% .%
%.....GP.....%.....%.%
% ..  .. .... %......%
%.. ... . .....  ....%
% .... .  .% ....... %
%. ... .... . ......%%
%........ .  . ..... %
% %%. ....... .......%
% ... ........ %.....%
%%% ........... .   .%
% .. . .. . .......  %
%%%%%%%%%%%%%%%%%%%%%%
