%%%%%%%%%%%%%%%%%%%%%%%%%%%%%%%%
%   . ...  . .... . ... .......%
%... ...... ..... . ..... .%...%
%..... . ..... . .  ....... ...%
%... ...... .. .... %... . .. %%
%...%.   .  .. ... .  ..  .....%
%.. ....%  .  . .... . ......  %
%  ..... ..   ..% . ... . . ...%
%. .  ........... .  .... .....%
%.. .....  . ......%.. .. .....%
%......... . %.   G  ......   .%
%....  ......  ............ . .%
%.....  .... .. ....%.... .. %.%
%.. ....%...... .P.. ..........%
%..   ..  . .%.  .... .G..... .%
% .  .....   .. .. ..%. ..   ..%
%.. .. .... .    .. %.. ... .. %
%. ..% .. .%....  %. ..  .%.%  %
%. .  . .% ...   . %...   . ...%
%%%%%%%%%%%%%%%%%%%%%%%%%%%%%%%%
