%%%%%%%%%%%%%%%%%%%%%%%%%%%%%%%%%%
%  %... ...%.........   .....% ..%
%.. ......% .%... . ..   .   ....%
%. ......... .......... .. %.... %
% ....%.  ....  . ..G.... .... . %
%..   %..... . %.  .. %%% %.. .% %
%...%. %.. ..... ... .  .. . .. .%
%.. ..   %.%....%..%P. .  %.%..  %
%... %.%..G. .. .. ...  ... .... %
%%... ..   ..%... .... ...... .. %
%.. .....G... .%....%..%  ... .  %
%%%%%%%%%%%%%%%%%%%%%%%%%%%%%%%%%%
