%%%%%%%%%%%%%%%%%%%%%%%%
%..% %.  ..............%
% ..... .  .%.  %.% .%.%
%. %.%.... ...... ..   %
%.  .. .%...... ....   %
%.... .. .. ... . ....%%
% ............. ...% ..%
%...... ... . . ...  ..%
%.   . ...... .........%
%. . %. .. . .. .......%
%...... %..   .%%.. ...%
%.. ..% .%..  ......  .%
%  ...%%  ....  .... ..%
%.. ..... .... ... . ..%
%. .. . ..... ... ... .%
%......... . .......%..%
% ..  ..  . ... GG  . .%
%    ...  .P...%.. ....%
%.... ...  .... . .% ..%
%%%%%%%%%%%%%%%%%%%%%%%%
