%%%%%%%%%%%%%%%%%%%%%
% ..... ....... ....%
%........   .. .....%
% ..  .  ...  ..% ..%
% .. %  . ... ..    %
%  .. ..   G%. .... %
%.%. . .. ....  ... %
%...... % ..   . .. %
%.   ... ......  ...%
%...% .%. ......... %
%..  . ..   ..... ..%
% . . .%.%. . ......%
%   .   .%. . %.. P.%
%%%%%%%%%%%%%%%%%%%%%
