%%%%%%%%%%%%%%%%%%%%%%%%%%%%
%.  . .... ... ..%. .......%
%% .......% .... ..........%
%..%.. .....G . ......%%..%%
%..%. . ...%.%. .... ...%..%
% . ..%...... . .. ........%
%.. P ...%   ......G.. ....%
%.. ..... ..... ... ... ...%
%.  .G. ...   .%... ...... %
%..........  ...%. %  %. ..%
%....... .... %. .. ... . .%
%.. .. .. ... . ..  .....  %
%%%%%%%%%%%%%%%%%%%%%%%%%%%%
