%%%%%%%%%%%%%%%%%%%%%%%%%%%
%  .. ....... ......  . ..%
%.G.%% ... . . .  ..... . %
% ...%%.. .. ....%. ..%...%
%...... ....%...........G.%
%.. .. . ........ . %.....%
%............  .. ....... %
% .% . ... .. ..... ......%
%  .......%.... ..  ..... %
%.... .%. . . .....%.  ...%
%......% .. . ......%G..%.%
%... .............%..   ..%
% .... . . .... ..%. .....%
%.. .... .... .% .....%%..%
%.%.%....... ......  . . .%
%..... ..% ..P.... .....  %
% ...%.... .....  ......  %
%%%%%%%%%%%%%%%%%%%%%%%%%%%
