%%%%%%%%%%%%%%%%%%%%%%%%%%%%%
% . .. .. . .%. ........ .% %
%..... .... ......G. .... ..%
%... ................%......%
% ...... ..G.. .. ....... ..%
%. ... %.......... ..%......%
% .P......... ..... ... ....%
%. ... ... . ... . ...  ..  %
%..%. ......... .... .. .. .%
%..G........... .......  .. %
%%.     .. ..... ... %. ...%%
% .. .%  .........%.  .. ...%
%.........%.......... .... .%
%%%%%%%%%%%%%%%%%%%%%%%%%%%%%
