%%%%%%%%%%%%%%%%%%%%%%%%%
%%.....% ....%....%%%  .%
%.. .....%...% . . .  ..%
% P.%.. .... .....%. ...%
%....%.%.. .%... .   ...%
%. ...........  .%% ....%
%..%.... .%.% .......%..%
%.....  ...... .%...%...%
%......% . %.......  ..%%
%..     ..... .%  %.%...%
% G  .. ....... . ......%
%%%%%%%%%%%%%%%%%%%%%%%%%
