%%%%%%%%%%%%%%%%%%
%......o.........%
%......oo%%......%
%..%..%......%o%.%
%%%..%....%%.....%
%...o..%....%.G..%
%o%.%..........%.%
%.....%......%.P%%
%%o....%.........%
%................%
%%.....%...o.%...%
%.......%........%
%%..%..%...%o....%
%o...%%.%...%..%o%
%..%...%..%......%
%.%...%..%..%....%
%....%.o........%%
%...%..%...%.o...%
%..%.%%...%.%..%.%
%...%......%.%...%
%%%%............%%
%...%.....%......%
%..%..%.%..%%.%%.%
%...%G....%......%
%....%......%....%
%......%.%...%...%
%...%%........%.%%
%.....%%..%.o....%
%....o..%..%...%.%
%.%...o%.%....%.%%
%...%...%.%.o....%
%%%%%%%%%%%%%%%%%%
%%%%%%%%%%%%%%%%%%
%......o.........%
%......oo%%......%
%..%..%......%o%.%
%%%..%....%%.....%
%...o..%....%.G..%
%o%.%..........%%%
%.....%......%.P%%
%%o....%.........%
%................%
%%.....%...o.%...%
%......%%........%
%%..%..%...%o....%
%o...%%%%...%..%o%
%..%..%%..%......%
%.%...%..%..%....%
%....%.o........%%
%...%..%...%.o...%
%..%%%%...%%%..%.%
%..%%......%%%...%
%%%%............%%
%..%%.....%......%
%..%..%.%.%%%.%%.%
%...%G....%......%
%....%......%....%
%......%.%...%...%
%...%%........%.%%
%.....%%..%.o....%
%....o.%%..%...%%%
%.%...o%%%....%%%%
%...%..%%%%.o...%%
%%%%%%%%%%%%%%%%%%
