%%%%%%%%%%%%%%%%%%%%%%%%%%%%
%...... ..............  ...%
%.... . .G...%%.......%....%
%% ... ........%....  ...%.%
%...........%. ..... ..%...%
%%G.%.....%. % ....... ... %
% .. ...... P........%. . .%
%.......% .....%......%..%%%
%....%........ .. . .......%
%.%.. %.... .%%......%.....%
%... . ..  .. .%%.... ..  .%
%%%%%%%%%%%%%%%%%%%%%%%%%%%%
