%%%%%%%%%%%%%%%%%%%%%%%%
% .%.%.. .  ...  ......%
%...% ... ... . ...  ..%
% ..... .... ...   ...%%
%. .  .......  .. .. .%%
%. ....  . .%..%.%.. ..%
%.......  .  .%. .. ...%
%...%... .. .. ......  %
%.%... ....... %... ...%
%...P  G .. .  ..% ....%
%.% ...  ..%..... .%% .%
%. . %.  ..............%
%..% .. %. . ....  ....%
%%%%%%%%%%%%%%%%%%%%%%%%
