%%%%%%%%%%%%%%%%%%%%%%%%
%.. .... .. ..%%  .....%
%......... .. .. ......%
%..%% ...  ... ... ....%
%.. ......  ...... ....%
% .....................%
%...... .. ... ........%
%.. . .%. .%.....%...  %
%... ..... ........ . .%
%... ..%.%..... .... . %
%%...%. ... ... .......%
%... %.%... %.G........%
%  ..%.. . ... ..  .%..%
% ......... ...........%
%.............  . ..P..%
%.%...G ....%..........%
%%%%%%%%%%%%%%%%%%%%%%%%
