%%%%%%%%%%%%%%%%%%%%%%%%%%%%%%%%
%. .. . . . ....... ...  . %.. %
%  ... .... ...... .... ..%....%
%. . . ....... ... % . . . ....%
%.... .. .%. %  %        .. .. %
%%..  ...%...%. .. ...... .... %
%... . .... % .. .  . . ..  % G%
%  .  .... ......... ... .P   .%
%.... ......    . .  .%. .... .%
%. ..  .. ...   ...... ... . ..%
%...  .  %   %. ......   ..% ..%
%%. ..  ..  ... .. . . ... ... %
% ..... .. . . ..... .... . ...%
%.... ...G  . .. . . ...... ...%
%.. . ....% .... ... .. .     .%
% .. ....   ..  . ...  ..... . %
% .. .  .. .....  .. .. . .  . %
%%%%%%%%%%%%%%%%%%%%%%%%%%%%%%%%
