%%%%%%%%%%%%%%%%%%%%%%%%
%. . %... .............%
%.%....%..%.........% .%
%... .... .......%.. ..%
%  .....%..%.....%.....%
%.............. .. ....%
%. %.... ..%. .........%
%.........%... ... ....%
%G.%... ..... %. ...%..%
%..%...%..%... %.......%
%........%.......%.....%
% . .  .%....P ........%
% %........ ...... ..  %
%..%%............... ..%
%%%%%%%%%%%%%%%%%%%%%%%%
