%%%%%%%%%%%%%%%%%%%%%%%%%%%%%%%
%.. .%..%.. % ... .... .. .  .%
%P.. ....% . %. ..............%
%. .   . .... %.% .. . . .....%
%..    .. . ...... .  ..  ....%
%..... .. . . . ...  .........%
%...   .. .... ... .% %.. . . %
% . ... .. .. ..   .G ....%...%
% .... %... .  % ..%..........%
%...  . .. .... ......  .. ...%
%....  ..% ...... .. ....% ...%
% ...G..  ... .......... .. ..%
%.  . ....%%  . .. .  ....   .%
%... .... ... ........ ...%...%
%. ... . .... . .... .........%
%..  .. ... . .. .  .... .%G..%
%.   .... .. ..%........ .    %
%..%...... .....   .  . ..   .%
%.. .. ..... ....  ...  ......%
%%%%%%%%%%%%%%%%%%%%%%%%%%%%%%%
