%%%%%%%%%%%%%%%%%%%%%%%%%%%%%%%%
%.....  ....  ....... . ..  ...%
%....  % . .. .. . . .... .....%
%.  .. .  ..   ......% . ... . %
%...%.P.. ... %  ..... .. ... .%
%...  ... . .  . .    .. . ..% %
% ...  G. .....  . . ... ......%
%........ %.. ...  ....  .  .. %
% .% .....  .. ..%.. ..% ...  .%
%.. ... .. .    ..%. ..... .. .%
% . . . ..   ..... ...... .....%
% .   .. %... ..... ..%.. .... %
% .  ... .  .%. ..  .  .... .. %
%...    . ..  .    ... .. ..% .%
% .%.. .  ....... %..   ... .. %
%%........ .   ...  ..  . %..  %
% .   .. ..%. . .... ..%.......%
%%%%%%%%%%%%%%%%%%%%%%%%%%%%%%%%
