%%%%%%%%%%%%%%%%%%%%%%%%%%%%%%%
% .. ....   %...  ........ G..%
%...%... ..........  .... .  .%
% .... .. . .....  ... ...%.. %
%.... ...... ... . .  ... ... %
%... ..%..... ..... .. ....  .%
%.. ...... ......... ...... ..%
%.. ..   ....   .......%......%
%%.... .P  .%. .%  . .......  %
% ...  . ...........  . ......%
%......%.% .. ... . .. ....  %%
%... . ............ ... . .. .%
% ..... ...  ....   .. .% . ..%
%...  ......% . ..... ...  ...%
%  ...........%  . .....G  .. %
%%%%%%%%%%%%%%%%%%%%%%%%%%%%%%%
