%%%%%%%%%%%%%%%%%%%%%%%%%%%%%%%%%
%%%. .  ..   . ..... %.   . ...%%
%.. . . .....  .. ... % ..... ..%
%.. ... . . .. ..   .%. P... ..%%
%....... . .....% .... G.. .....%
%............ ........ .. ... ..%
% ....% . . .... ..% .....   ...%
%....  .. ... . . . .. .  G ... %
%.G .. ...%  . ...% %. ..%..%...%
%%%%%%%%%%%%%%%%%%%%%%%%%%%%%%%%%
