%%%%%%%%%%%%%%%%%%%%%%%%%%%%%%%%%
%..... .. %. ............ ..... %
% %..  . . ... ........... .  ..%
%      ............. .......... %
%. .  . ...... ... .. . ..... %.%
% .. . %.%. .. ..... . ...%.....%
%... ..%. .  . ..... . .... .. .%
%. .  .    ......% .. . . .. ...%
% .... ..... .....  .  . . .. ..%
%..  . . . G.... .   %.. ..   . %
% ......%.  . . %..% . %.. ... .%
%. . ..  %. ...  .    ....%.. ..%
%%......  .... ... . . .......  %
%........  ... ... ... ... .....%
%. . .    ...P.. ... ..  . % ...%
%. . .. %  ...% .  ..  ......%..%
% ....%.%...%. ..... . .... ..  %
% .  . ..  .... .....  . ..  .. %
%%%%%%%%%%%%%%%%%%%%%%%%%%%%%%%%%
