%%%%%%%%%%%%%%%%%%%%%%%%%%%%%
%......%................ ...%
%  ....... . %.....%%..... .%
%% ...%..... %... .........%%
%..%.......... ..  . . .%...%
% ...G. ... P.. % ... %..   %
%%.......... ..........%%. .%
%.%.........%...  ... ..%...%
%.%. ... %. %  ..... %%%%.G.%
%..%..%........   ..........%
%..G%........... ..... .....%
%%%%%%%%%%%%%%%%%%%%%%%%%%%%%
