%%%%%%%%%%%%%%%%%%%%%%%%%%%%%%
%. ... . ..  ...  ..... .....%
%..... ..  .. %...  . % ...  %
%.... . .. ...  .. %.. ......%
%   ... ..  ....   ....  ....%
%... ..... .. %..  . ....   .%
% .........%... ... .%%  .. .%
%   % . P.... ..  . .... .. .%
%.. . .. .      ......%%.....%
%. ...  .%...... .. .....%.. %
%.....   ..  .. .    .    ...%
%% ..%... ..   .  . .. % ....%
%...%..%. . %. .. .  ........%
%  .... ............ .......%%
%... .......G....... .. %.. .%
%... . ... ..... ......  ....%
%......... .. .... ..%.....  %
%.......%. . .%...  ...  ....%
%  . ...   . ..%. . .........%
%%%%%%%%%%%%%%%%%%%%%%%%%%%%%%
