%%%%%%%%%%%%%%%%%%%%%%%%%%%%%
%.. %.... %  .. .  ...... ..%
%. .. . . %..  .. . ..... . %
%. ....   ... . ..  ..%. ...%
%...% .P  . ........%..  .  %
%. ....%..  %.. . . .  .% .%%
%.. .  ..  .. .......  ..   %
%. .. ..  ...%..%....  ..% .%
%..  . ....... .....  ..%...%
%.......... ......  .. %  %.%
%.... ....  % .   %   ..G...%
%%  ...  .. .  .....   .... %
% %.. ..% . .  % .. ..%....%%
%.%  ...%....  . .  ..%...  %
%%%%%%%%%%%%%%%%%%%%%%%%%%%%%
