%%%%%%%%%%%%
%..........%
%....%..%..%
%%....o%...%
%.o.%...%.%%
%.%...%P.%.%
%%.%....%..%
%..G.%.....%
%%.%..%.%.%%
%........%.%
%...%.%...%%
%%G%.%o....%
%.o....%...%
%%%.%%..o%%%
%..%....G..%
%..o.%%.%..%
%..o.......%
%.o.%%.%...%
%........G.%
%......o.o.%
%.%..%%%...%
%%%%%%%%%%%%
%%%%%%%%%%%%
%..........%
%....%..%..%
%%....o%...%
%.o.%...%%%%
%%%...%P%%%%
%%%%....%..%
%..G.%.....%
%%.%..%.%%%%
%........%%%
%...%%%...%%
%%G%%%o....%
%.o....%...%
%%%%%%..o%%%
%..%....G..%
%..o.%%.%..%
%..o.......%
%.o.%%.%...%
%........G.%
%......o.o.%
%%%..%%%...%
%%%%%%%%%%%%
