%%%%%%%%%%%%%%%%%%%%%%%%%%%%%%%%%
%  . .  .... . ...  .. .... ....%
%.   . ... .. ......G. .. .. ...%
%....  .  . . .  .. . . ... ... %
% .. . ...G .. ..  ... ..   ....%
%. ... .  .... ... ........% .. %
%. ....... .. . .   .. ....   . %
%.  %. .%.  .... ... ...... .  .%
%% .. . ....  .. .. ..     . ...%
%P ....... .... ...  .... ..%% .%
%...  .. ... .%..  % ..% ..  .. %
%. .. . .... %  .    ..... . .. %
%.  ..  %. ... .. .... ..... ...%
%%.....  .  .....  G.. ..    .  %
%... . .   %...%. ..     %  ....%
%. ...... . . . ...  ...  .... .%
%%%%%%%%%%%%%%%%%%%%%%%%%%%%%%%%%
