%%%%%%%%%%%%%%%%%%%%%%%%%%%
%......%..%....   . .....%%
%% ..%. .... .... ..%.....%
%... .. .. .%..%...%..... %
%.%.   ..%......%..  .%...%
%.....G...%. ..........P..%
%.. .... %... ............%
% ...................%...%%
% ..G.%...........% . ....%
%..........%.......%. .. .%
%..... ... .. ....... ....%
%.......  .%.  ...... .. %%
%...... . . ...  ....... .%
%.. ... ... ..... .%.... .%
%%%%%%%%%%%%%%%%%%%%%%%%%%%
