%%%%%%%%%%%%%%%%%%%%%%%%%%%%%%
%.... %.....  ..... %.  P.. G%
%........ . ....... . .... ..%
%... ..... .. .. .. .....%...%
%. ... .. .... %....... .  . %
%.%... . ...  ...   % ...  . %
%...%.... ..%.....%.%.. .... %
%... .... .. ....... . ..... %
%..%....%.  .......%..%..%...%
%.%.   .%..% ..G...% . ... ..%
%%... .%..... .... .. ....%..%
% .  .. ..% .. ... ......%..%%
%%%%%%%%%%%%%%%%%%%%%%%%%%%%%%
