%%%%%%%%%%%%%%%%%%%%%%%%%%%
%..  .G....... .... ......%
%  .. .    ... ... .% . ..%
% %.. ..%  .... . ..%..   %
%. .. ... . . ....  .. .. %
%  ...    ... %.. ..G. .. %
%%. ..    .. ...   ..P ..%%
%  .... ....... ... ... ..%
%% .. ...... .  ..%. .....%
% .. .% .%. .% ....  .  ..%
%.. ... %. .  .... . ... .%
% ......  .  ..... .......%
%..%..%.%.%....... .  ....%
%... .  ......... . . ... %
% .. ..... ... %..    %. .%
%....%..  ....... .... . .%
%%%%%%%%%%%%%%%%%%%%%%%%%%%
