%%%%%%%%%%%%%%%%%%%%%%%%%%%%%%%
%.. .. .  . ... . .. .. .%.. .%
% .....  .... . . .    ... ...%
% .. ..  ...%. . ..  .........%
%. ....... .. .... ..  %.. ...%
% .........  ...G ...... .. ..%
%%. . . ... ...  %...G... . . %
% . . ... .  ....  .........  %
%. ..... ..  ...%.. ..........%
%.  ........  .P. . ...... . .%
%.. %.  .% . ..... ... % .....%
%. ...  .    ... . .   . .%%. %
%. ..  ..   ..   ...... ..  . %
% .%.%...  .... ... . ... ... %
%. . ... .  . .  .... . .. .. %
%.. . .....   .   .. .... . ..%
% .. ....... ..%..% .  .......%
%  .....%   . ....    ... .  .%
%%%%%%%%%%%%%%%%%%%%%%%%%%%%%%%
