%%%%%%%%%%%%%%%%%%%%%%%%%%%%%%%%%%
%.   ...%...  ..   .  .... ..  . %
%..  ... .... .. ..... ..... .   %
%. ... . . .   . ..... ... ......%
% .  . ..   ................ ....%
% P ... %...  ..  .. . ......... %
%...%.... ...% ......... .   %...%
%%..... ...... .. . .. ..........%
% ..%..... ... ..  .   ......... %
%. .. ...... ........ .%.   ...% %
%. .    ..   ...... ... .. ..... %
%... .. .....  ...   ....... .  .%
%.G . .... . .......   .  . ..% .%
%. .. .........  ....... ... . ..%
%  .. ..........   ... ... .. . .%
%.... .. . . . ....%..  .. .  . .%
%%%%%%%%%%%%%%%%%%%%%%%%%%%%%%%%%%
