%%%%%%%%%%%%%%%%%%%%%%%%%%%%%%%%%%%
%..... . ... .............   .%...%
% . ....  .%............ .%....  .%
%..G........ .....  . ....% ......%
%. .. . G.. ...%....%. ...   .. ..%
%. ..  .G. .  .... ... ..... ... .%
% ..... . ....%.... %... .  ... .%%
%. ........ ............%.. .%.  .%
% .... ......... ...... ..  . .  .%
% . . .... ... . ....%.. ........ %
%.......... .. ..... ...%... .. ..%
%......% .  ...  . .. .........  .%
%..... . .  .... . ..%  .. . .....%
%.  ...... .%...   .. .. ......G..%
%. ... .%..... ... %..... .......%%
%. . ...... ..%. .... ..% . .  ...%
%...  . ..... . .. . ......... .. %
%... .. . P....  .....   ........ %
%.. .  .....%..... .. . ... %....%%
%%%%%%%%%%%%%%%%%%%%%%%%%%%%%%%%%%%
