%%%%%%%%%%%%%%%%%%%%%%%%
%....%............%....%
%....... ..............%
%..%%%  .... ..........%
%.. ........ %..%. ....%
%... ... ..... ........%
%.... ............ .. %%
%.%..   .. .. .. .... .%
%...... . ..... . .....%
%...%....... . .%......%
%% . .%. ............. %
%%............%...%.%..%
%. .........%%...%.. ..%
%P%   ......G...  .....%
% ....%..%...%........ %
%%%%%%%%%%%%%%%%%%%%%%%%
