%%%%%%%%%%%%%%%%%%%%%%%%%%%%%%%%%
%.....  .... .... .. %.% .   . .%
%... %.... .   ......... %.%....%
%. .....  ... .%.. ... P. ....  %
% ..%. .... ..G....G . %.. . . .%
%.  .  %... . .  ...........  ..%
%...%. .. ............G........ %
%.  ............ ...... . . ....%
%. ... . ....... ...............%
%%%%%%%%%%%%%%%%%%%%%%%%%%%%%%%%%
