%%%%%%%%%%%%%%%%%%%%%%%%%%
%.%. .% .... .  ..... .  %
% ......... .. ...%......%
%...% .........%.........%
% ... . ....%.  ..... .. %
%.. .. .. ..... .  .... .%
%.. .. .... ........ ....%
% ..... ..  ..... ..P.%..%
%  ............. .... .. %
%.. ...... ....... .  ...%
% .  .. .. .% %.... ....%%
%. .. ... %....... ..G.. %
%.. .... . . .. G.. . .. %
%......  ... ........  %%%
%.... . .....G... ...   %%
% ......%.. . ....  .... %
%%%%%%%%%%%%%%%%%%%%%%%%%%
