%%%%%%%%%%%%%%%%%%%%
%.............%. . %
%.... ....%.. .....%
%.  ........ .. . .%
%.%...%... ......%.%
% ....G..... ......%
%... .....  .......%
%...........  .. ..%
%.  ...............%
%.....%. . ...%. ..%
%...% .. .......%..%
%%%...........P. ..%
%. ..%.....%.......%
% ...%.. .%..%.. ..%
%.... ...... %..%%.%
% % ...............%
%%. .........%..%..%
%...... ...... ....%
%%%%%%%%%%%%%%%%%%%%
