%%%%%%%%%%%%%%%%%%%%%%%%%%%%%%%%%
%.... . . .P... .. ...... ....  %
%.......... . ... ..   .. ..    %
%   ....... .. . . ......   . G.%
%. ........  . . ...     .. %.. %
%... .... .. ..% .  .  .% .. ...%
%...... . .  .  ...... .  ......%
%... .  ..... . ..  .%.. .. ... %
%..... .  ... . ......... ..  ..%
% ....%.  ......% .....  ..  .  %
%    . ..% .... ..     .... ... %
%. .. .. ....... .....   ...   .%
%.. G....%.  .% %..  ..%...  .. %
%.. ..G.. .... ..   .. .. . .   %
%.... ....  . .......%.... . .. %
% . .%.. . .    . .... .... %. .%
%    . .. ..........    ...... .%
% .%... ..  .. ...  .... ..  ...%
%.  .  ...%. .... .  .....   .  %
%%%%%%%%%%%%%%%%%%%%%%%%%%%%%%%%%
