%%%%%%%%%%%%%%%%%%%%%
%..   ..   .. . .P .%
% .. ...... . % ....%
%....%.. % . .....%.%
%.%..   ..  ..  ... %
%.%..%.G.......  ...%
%.. . %.... ... . . %
%.%... .....  %.  ..%
%.%% .. ... %  .....%
%.... ..  ......  %.%
%...........  .%....%
%... G..... ........%
%  ..... ..% .... ..%
%%%%%%%%%%%%%%%%%%%%%
