%%%%%%%%%%%%%%%%%%%%%%%%
% . ... ......  .......%
% ........ .%..........%
%..........%%..... ..%%%
%. ..........%........ %
%. ... ............  ..%
%.....%........ .......%
%.. .. .. %.%..G.%. ...%
%%....... ...%.... ....%
%. .. . ..% .........  %
%.. %.. ..... ..P..%. .%
%.... ...... ...%.%....%
%...%..... .... .......%
% .....%... . ....... %%
%... % %.. ............%
%....%..%. ....... ... %
% .........%%.......  .%
% .%.............%.....%
%%%%%%%%%%%%%%%%%%%%%%%%
