%%%%%%%%%%%%%%%%%%%%%%%
%% .. ...%.  %. ... ..%
%%... GG. ... .  .  . %
%.G ... ...... . .%  .%
%  .... %... ... .....%
%.%% . .  ........%...%
%....%%%   ..%.. .. .%%
%.......... ..  .. . .%
%..    .....   ..%. %.%
%...  .. . . ....... .%
%. .  .... ..%%..P .%.%
%..%  . . %.  .  .. %.%
%....%.... .%  . ..   %
%..%.  ....% ....%.% .%
%%%%%%%%%%%%%%%%%%%%%%%
