%%%%%%%%%%%%%%%%%%%%%%%%%%%%%%%%%%
%. ..... .   .. . ..  ... ..  . .%
%... .............% ............ %
%.. ..  .G %....  ..... .  . ....%
% .   ... ... .. %.... ..... ..  %
%.. ..%......% . ... . %.. .. . .%
% ... . .  .. . ..... ....   .  .%
% .. ...... ... .  .% ......... %%
%... .............  .. % %..  ...%
%   ... .. ... ..%. % .. ....  ..%
%........ . ........ ...  ...   .%
%..... ...%.. ... .. .... .... ..%
% ....  ...........  . ....  . ..%
%.. .......... ...  ....%....  ..%
%%. .. .. ... . . ...  . ...  ...%
%....%  .... . ......% ......... %
%..% .....%.......  ....G.  .....%
%.....  .... . ......... ....   .%
%.. ..... .P.....%%. ....  ..... %
%%%%%%%%%%%%%%%%%%%%%%%%%%%%%%%%%%
