%%%%%%%%%%%%%%%%%%%%%%%%%%%%%%%
%...%... ..............%.%....%
%. .. ..........G....  ......%%
%.....G....%... . .. .....%%..%
%...... %.........%. P.%.... .%
%.... ..%% . . ....... ..%....%
%.%........... . ........ % ..%
% ........%..%...... ...... .%%
%.....%......%... ...% .%...G %
%....  .....%..... ........ . %
%%%%%%%%%%%%%%%%%%%%%%%%%%%%%%%
