%%%%%%%%%%%%%%%%%%%%%%
%...   % ...... .... %
% ... . . .. ...  .  %
%.  . .%.   . ...... %
% .% ....... .% .%   %
%... . . ...  ... ...%
%... ....          ..%
%  . ...%... ....  . %
%... . ...  ..  ... .%
%..%. . ..%. G..... .%
%...   . ....  .. ..%%
% . .  .... %..   ...%
%... ..  . % . . .  .%
%. ........ .. ..... %
%..%.   ... . .......%
%.. ... ..... . . . .%
%....%.... .   . . ..%
%... . . .  .  . .% .%
%   .... .  .... %%P.%
%%%%%%%%%%%%%%%%%%%%%%
