%%%%%%%%%%%%%%%%%%%%%%%%%%
%.. %.... ......  % ... .%
%........%...........%  %%
% . ... .%...%.%.........%
%%. ...... .......  .....%
%.%..%% .. .......... ...%
%.  ...... G... ... .. ..%
% ......... ....... .....%
%.%.... . ...P. ....  ...%
%%%%%%%%%%%%%%%%%%%%%%%%%%
