%%%%%%%%%%%%%%%%%%%%
% .......%.... ....%
%....%% ..%....... %
%%...%...  . .G...G%
%....... ..........%
%. .. . .P. % .... %
%.....%.%......% ..%
%............%...%.%
%...... .. ........%
%... ....... G. ...%
%%%%%%%%%%%%%%%%%%%%
