%%%%%%%%%%%%%%%%%%%%
%..%..... .. % %.. %
%...%..%. . .%. . .%
%G...  %......%. %.%
%.% ..%......  . ..%
%%P... .%....%. . .%
%.... ....  ....% .%
%.% ..... ...%.....%
%%... %.%.%.%... .%%
%%%%%%%%%%%%%%%%%%%%
