%%%%%%%%%%%%%%%%%%%%%%%%%%%%%%%%%
%......... ..G.......... %......%
%%. ... ...%...... ........ .  .%
%.... ..... %....... .... %.....%
%. .. .%....%.    .   .....%....%
%.... ..%... . ....  . ....  .. %
%..... .%......... .. ...  .%.. %
%... ..... . ....  .% ......... %
%.... ..... %.... .. ..... %... %
%... .......... %.%  ...........%
%....  %... .......%% ...%  P...%
%%%%%%%%%%%%%%%%%%%%%%%%%%%%%%%%%
