%%%%%%%%%%%%%%%%%%%%%%%%%%%%%%%%%%
% .  . . ... ......... ....%  ...%
%..... ... ..... .. . .. .%. .. .%
%..... ...... . ...  % . .... . .%
% . ... . ........ .  ....  . ...%
% .... . .... .  ..  .. .. P.....%
%.  .... ..%...... ... ....  ... %
%. .. ..... ..  ....   . ........%
%. .  .. ..........  .....   ....%
% .. .  ...%.... ... .% .........%
% .. ... .. . .. ... .  ...... . %
% %....  . ...G.. .... ......... %
%.... ..... .. .... .......  %  .%
%.% .... ...  .. .... ..... ..%. %
%..  .... ... ...   ... .. . .  .%
% ........ .% . .....  . ........%
%. .... G. . ..G.     ..%....% ..%
%%%%%%%%%%%%%%%%%%%%%%%%%%%%%%%%%%
