%%%%%%%%%%%%%%%%%%%%%%%%%%%%%%%
%........... ... .. .... .....%
%..........  ..  .........  .%%
%... ........  .. ......  . ..%
%.. ..% . ...%  ....  . % %.. %
%  %.% . .... .. ....... ..%.%%
% %.... ..... ... %... ... .  %
% .. .... .. %..   ..  . ... .%
% . ... ..........  .... ... .%
%....... ... .%..%. .% .. . .%%
%.. .. . .... .....  . .. .. .%
%  ...... P .... . .. .....% .%
%.......... ...........%.. .%.%
%.%%G..% ... ...  ... ........%
%%%%%%%%%%%%%%%%%%%%%%%%%%%%%%%
