%%%%%%%%%%%%%%%%%%%%%
%..... .%.. .%..... %
%.. .... . G..%.....%
%..... .%.....   .. %
% . .%  ........ .. %
%...%. .............%
%..... . P ....  .. %
%...................%
%...... .... %..  ..%
%. .. ... ... ...%..%
%...... ..%.G..... .%
%%%%%%%%%%%%%%%%%%%%%
