%%%%%%%%%%%%%%%%%%%%%%%%%%%%%
%  P.....  . ...G.  .%... % %
%..% . .......... .... . %..%
%%  .... . .. . . %.. .%. . %
% . ..%... ..  . %.% ..G. ..%
%........%%   .....   ..  ..%
%....  %...  . ...% .... ...%
%... %.. .....  . ..  %. . .%
%.. ...%...   %..........% .%
%%%%%%%%%%%%%%%%%%%%%%%%%%%%%
