%%%%%%%%%%%%%%%%%%%%%%%
%. . ...%.... %G......%
% . . . . .... .   ...%
% . .% ..%%. ....%. . %
%.. ....%. %..........%
%.%.  ... .. . ... ..%%
%. ........% .. %  ...%
%....  ..... ....P..  %
%..G.... .  .. .. ... %
%  ...%... .. .....%%.%
%... ...  ... . ..... %
%... .. ...... ..%.G .%
%.. ........ . . ..%  %
%. ... ...... . ... %.%
%......% %. ..........%
%..... ...%% ..%  ..%.%
%%%%%%%%%%%%%%%%%%%%%%%
