%%%%%%%%%%%%%%%%%%%%%%%%%%%%%
%..... .... .... ........%..%
%...  ... .... . ........%..%
%.. . ...%..... ...    .....%
%.....% .% .......... .... .%
%... %.... . ..%..%.. ......%
%....... ....... ..... . . .%
%..... ............. .... . %
%.. . . .... .. ... .....  .%
%....G.  ...%.  .. .... ....%
% . .    %... ..... .......%%
%%..  ........ . %.. .......%
%...  . ..P..... . ... .. ..%
%...... .. ..... ... ...... %
%. .. . ...... ............ %
% ....... . . . ...... . %. %
%  .. ..... . . .. ... .....%
%%%%%%%%%%%%%%%%%%%%%%%%%%%%%
