%%%%%%%%%%%%%%%%%%%%%%%%%%%%%%
%..............%.. ......   %%
%..  .. ... ..........  . . .%
%%.... . ..% ... ............%
%...  ... ............ . ....%
%........... .%......... .P..%
%....%.............. ...%....%
%.. ..  ...%............  .. %
%........ G  .............  .%
% . ...%... . .... ...... . .%
% .. .... ...................%
%............  ...... .. .. .%
%. ..... . ....   .... ....  %
%. ..  .. .. .... . ... .....%
% . %. . ... .. ........ ... %
%%%%%%%%%%%%%%%%%%%%%%%%%%%%%%
