%%%%%%%%%%%%%%%%%%%%%%%%
% .%......  ...... ....%
%...%.%....%.......%...%
% ... .%...............%
%. ..%... ... ..%......%
%.............   %.G..%%
%..... ..%. ... ....%..%
%.G.............%.....P%
%.....%..%...%%G.... ..%
%%%%%%%%%%%%%%%%%%%%%%%%
