%%%%%%%%%%%%%%%%%%%%%%%%%%%%%%%%%%
%....   .  .. . .%..% %.... . ...%
%. . . ... .. G. . ..  .. . .... %
%....  ...    % ... .%...%.. .. .%
%  %... .  ..%..... .  .. .  . . %
%  . ..... ....... ...    .......%
%.. .   ... ....% .. .%% .....  .%
% ... .. .... .%...% ..  .. . ...%
%.....G... . ... . ..............%
%.P. ........ ............. .....%
%.. .............. ... ..%...  ..%
%  .% %.%....   %.%. ... . . .   %
%..  . ........ .. ..... ... ....%
%%%%%%%%%%%%%%%%%%%%%%%%%%%%%%%%%%
