%%%%%%%%%%%%%%%%%%%%%%%%%%%%%%%%%%
%.. ......%%... . . ... .. .... .%
%... %..%....... ..... .. .......%
%..%...%P.. .  .. .........%.....%
%. %....... . .. %..%.. .......%.%
%% ... ................ .... ...%%
%.....%.%..... .......... . .....%
%.. ........ .. ... ..%.......G..%
% . .%.. ...... .. %.. ..... ....%
% %........%. . .%........... ...%
%. ......%... %.... .%  ........ %
%%%%%%%%%%%%%%%%%%%%%%%%%%%%%%%%%%
