%%%%%%%%%%%%
%.%....%...%
%....G.o.%.%
%.%........%
%.G..o.....%
%..G.......%
%.....P....%
%%%%%%%%%%%%
