%%%%%%%
%.....%
%..oGP%
%.....%
%%...G%
%...G.%
%%%%%%%
