%%%%%%%%
%.oo...%
%o.....%
%......%
%......%
%.P..G.%
%%%%%%%%
