%%%%%%%%%%%%
%.......%..%
%...%..%G..%
%.o.G..%%..%
%...%.G.P..%
%%%%%%%%%%%%
