%%%%%%%%%%%
%.o....o.%%
%%%%......%
%...%P.G..%
%%%%%%%%%%%
