%%%%%%
%..%.%
%.GG.%
%.%%.%
%....%
%oo..%
%....%
%....%
%...P%
%%%%%%
