%%%%%%%%%
%.o.....%
%...%...%
%%.%....%
%...G.o.%
%.......%
%%......%
%..%...%%
%%..G.%P%
%%%%%%%%%
