%%%%%%%%
%....%.%
%%..PG.%
%...G..%
%......%
%%%%%%%%
