%%%%%%%%%
%.......%
%%..G.P.%
%...G%..%
%%%%%%%%%
