%%%%%%%%%%
%o..%%...%
%.G.%G.o.%
%........%
%.o.....%%
%%......%%
%........%
%.P%.....%
%%%%%%%%%%
