%%%%%%
%....%
%....%
%oGP.%
%%%%%%
