%%%%%%
%..%.%
%...%%
%%..G%
%...G%
%...P%
%%%%%%
