%%%%%%%
%...%.%
%.....%
%.GGP.%
%%%%%%%
