%%%%%%%
%..%..%
%.%...%
%..%.G%
%.P..%%
%..G%.%
%...%%%
%...%.%
%%....%
%%%%%%%
