%%%%%%%%%%%%
%..........%
%.%..G.....%
%..........%
%..%..%....%
%.%%%....P%%
%..%.......%
%%%oG...%%.%
%%%%%%%%%%%%
