%%%%%%%%%%
%........%
%.....%G.%
%...P...G%
%%%%%%%%%%
