%%%%%%%%%%%
%....%....%
%..%...%G.%
%.%%...o..%
%......%..%
%o.......%%
%%.%......%
%..G%.o%..%
%.....P...%
%%%%%%%%%%%
