%%%%%%%
%..%..%
%.G...%
%%.P..%
%.....%
%..o..%
%..G.%%
%..%.%%
%%%%%%%
