%%%%%%%%%%%
%%.o......%
%%......P.%
%..%..G...%
%......%..%
%.......%.%
%..%......%
%.........%
%%%%%%%%%%%
