%%%%%%%%
%......%
%.G.%.G%
%...%P.%
%%%%%%%%
