%%%%%%%%%%%
%........%%
%%...GP...%
%...%....%%
%....%....%
%.%..G....%
%o.%....G%%
%%%%%%%%%%%
