%%%%%%%%%%%%
%....%....%%
%..G.P.....%
%...G......%
%%..%......%
%%%%%%%%%%%%
