%%%%%%%%%
%..o.o%%%
%.......%
%o..%...%
%...o...%
%.......%
%.o...Go%
%.P%...o%
%%%%%%%%%
