%%%%%%%%%%%
%.........%
%.........%
%..o......%
%......%..%
%........%%
%......%..%
%.....GG..%
%.%.o%P...%
%%%%%%%%%%%
