%%%%%%%%%%%%
%..........%
%...G%.....%
%.......%.G%
%....%.%%P.%
%%.....%...%
%...%....o.%
%...G......%
%%%%%%%%%%%%
