%%%%%%%
%o..%.%
%....%%
%.....%
%...G.%
%...%P%
%...%.%
%%%%%%%
