%%%%%%%%%%%
%.......%.%
%.......GP%
%.G.......%
%....%G...%
%......%..%
%%%%%%%%%%%
