%%%%%%%%%
%...%...%
%..o.G..%
%.......%
%.%P%..G%
%.....%.%
%%......%
%%%%%%%%%
