%%%%%%%%%%
%....o..o%
%.P%.....%
%.%......%
%....GG..%
%........%
%...G....%
%....%%..%
%%%%%%%%%%
