%%%%%%%%%%%%%%%%%%%%
%........... ......%
%.%.... . .. .... .%
% ........ ..%G. ..%
%  . P.... ..%. .. %
%%....%%..   ......%
%.  .... % .... . .%
%%..............  .%
%%%%%%%%%%%%%%%%%%%%
