%%%%%%%%%%%%%%%%%
%......% %.... .%
%.  .G ..... ...%
%....G..  ....%.%
%.. ............%
%............. .%
%....... .P  .  %
%........% .....%
%..  ..% ... . .%
%%%%%%%%%%%%%%%%%
