%%%%%%%%%%%%%%%%%%%
%......... ...... %
%.......... %  . .%
%.... .%..%.. ....%
%.. %..P% .%.%G%% %
%%................%
% ..G... ..% ..%..%
%%%%%%%%%%%%%%%%%%%
