%%%%%%%%%%%%%%
%. .. .P... .%
% ... ...... %
% .. .. ..%  %
%..  . . ... %
%.%. .... %..%
%...  %.G .G%%
%%.. . %   ..%
%.%..........%
%%..  ..%.. .%
%%%%%%%%%%%%%%
