%%%%%%%%%%%%%%
%...%.... %  %
%............%
%  ....P....%%
%.....%. ....%
%  .......%..%
%. ..........%
%.%..  ... G.%
%..%...%.. . %
%%%%%%%%%%%%%%
