%%%%%%%%%%%%%%%%%%%%
%.% ......... %..P %
%. ..% ..%... .. G.%
%..... ....%G......%
%..........%..  . .%
%.%.......%..%.....%
%....%..G......%..%%
%.  %..........  ..%
%%%%%%%%%%%%%%%%%%%%
