%%%%%%%%%%
%..o...%.%
%%%....%.%
%..%%....%
%%..%%...%
%o.....o.%
%...%.%%.%
%....%...%
%%%...o..%
%.G......%
%..%...%%%
%oG.%..%.%
%......%P%
%...%.%..%
%....G.%%%
%o.%.o..%%
%....%%%.%
%...%....%
%%%%%%%%%%
