%%%%%%%%%%%%%%%%%%%%
%    .%.... .......%
%  ...... .G..   %.%
%... .% .. ... .. .%
%%. ......  .%... .%
%...  .... ..  ....%
%.%............%.  %
%.  ..%......P.% . %
%%%%%%%%%%%%%%%%%%%%
