%%%%%%%%%%%%%%%%%%
%....... ...  ...%
%...... .%.  ... %
%  . .. ..  .....%
%..... ....... ..%
%...%.... ...... %
%.  .. .....   . %
%. ..%.% . . .   %
%G...%P  ........%
%%%%%%%%%%%%%%%%%%
