%%%%%%%%%%%
%.%......%%
%....%.%..%
%%...%....%
%%.%......%
%...%.%..o%
%.%.....o.%
%.....%.%.%
%...%..Po.%
%.........%
%...G.%...%
%.%%...o..%
%.........%
%....%Go..%
%%%%%%%%%%%
