%%%%%%%%%%%%%%
%%.... ... . %
%......... G.%
%..%.... ....%
%. ... ..%...%
%. .. ...%...%
%   % . .. .G%
%.%..... ...P%
%%%%%%%%%%%%%%
