%%%%%%%%%%%%%%%
%.  ...G%  . .%
%.. ..... ....%
%. .. ....%.%.%
%P..  %.%... .%
%%. .. %....  %
%.%.....%.%%..%
%.  . ..G.....%
% ..... %.....%
%%%%%%%%%%%%%%%
