%%%%%%%%%%%%%%%%%
% ..%.  ......% %
%....... .. %. .%
%..   .......  .%
%... .... .% ..%%
%. ... .. ... . %
%%. . ..  .%  ..%
%.  .P  . .   %.%
% . .   ..%%... %
%...%.... .. ...%
%%.... ....G.  .%
%%%%%%%%%%%%%%%%%
