%%%%%%%%%%%
%%.%%...o.%
%...o..%%%%
%.%%%%..%.%
%..%.%..o.%
%......%.%%
%....%..%%%
%......Po.%
%%.%o....o%
%%G%.o....%
%......%..%
%..%...%.%%
%o...%....%
%..o...%%%%
%....%.%.%%
%.........%
%.........%
%.......G%%
%%%%%%%%%%%
