%%%%%%%%%%%%%%%%%%%%
%...%. . .. ..G ...%
%. ... ..... ..... %
%...%.... ... . . .%
%.. . ... ..%.. ...%
%.........%...... .%
%.. .......%.....G.%
%....  .G.. .. ....%
% .....   .P.%.....%
%%%%%%%%%%%%%%%%%%%%
