%%%%%%%%%%%%%%%%%%
%... .. .  . .% .%
%%  %. .. ..P    %
%.... . ....  . .%
%... .  ... ..%. %
% . . G ... ...% %
%  ... ...   ....%
%  .%. ......   .%
%%  .. ..........%
%..  .... .... ..%
%.. ...% ... ... %
%..  .%. ..  .  .%
%.. ..   ..... . %
%%%%%%%%%%%%%%%%%%
