%%%%%%%%
%%%.o.%%
%......%
%%.....%
%....G.%
%.%%...%
%...%%.%
%..%...%
%o..%%%%
%...o%.%
%..%...%
%%%P..%%
%o%...o%
%......%
%%%%%%%%
