%%%%%%%%%%%%%%
%.%.....%....%
%.......%....%
%..........%.%
%.%.......%..%
%..%P..%G.%..%
%.....%%...%G%
%%%%%%%%%%%%%%
