%%%%%%%%%%%%%%
%.. .  .. . %%
%...... .....%
%.. .%.. . . %
%. .....%.  .%
% ...   . .  %
%....%......%%
%...  .. % %.%
%.%....... . %
%%........ ..%
%.%.%%. ....P%
%....   .... %
%...  .....G%%
%%%%%%%%%%%%%%
