%%%%%%%%%%%%%%%%
%.. .... .....%%
%...... .G... .%
%..... .... . .%
%..............%
%........ .....%
%...%... %.. ..%
%.. . ....%.P .%
%.. .  .%%..%..%
%%%%%%%%%%%%%%%%
