%%%%%%%%%%%%%%
%....o....%%%%
%....%%....o.%
%....G.......%
%%%....%.....%
%.o%.....o.%.%
%....o%%%....%
%........%%.o%
%......%...o.%
%.o.......%..%
%%.....%...%%%
%..G.%%.%%%%%%
%%...G.......%
%...%....%...%
%...%%....%..%
%.%..%......o%
%..%%o.......%
%o.....o.%.P%%
%%%%%%%%%%%%%%
