%%%%%%%%%%%%%%%%%%%%
%. .......... ... .%
% .. .. G .. . ....%
%% .. ..  .%.......%
%.... ..% .........%
%....%........ ....%
%% .P.%%... .%.%..G%
% . .....  .. ..  .%
%........%.%..... .%
%. .%%G . ...%. ..%%
%%%%%%%%%%%%%%%%%%%%
