%%%%%%%%%%%%%%
% .. ..%. ...%
%..G.G..%P...%
%.......%.%..%
%........... %
%.. . %......%
% ...%.......%
%%%%%%%%%%%%%%
