%%%%%%%%%%%%%
%...  P%.. %%
% . ....... %
%GG...... ..%
%..  .....%.%
%.. .....   %
%..%.... .. %
%%%%%%%%%%%%%
