%%%%%%%%%%
%........%
%..%%..%.%
%..%.....%
%.%%...G.%
%.G......%
%.%.....o%
%%..%%...%
%....%...%
%.....%..%
%....G..%%
%o.......%
%........%
%.%P.%..o%
%........%
%%%%%%%%%%
