%%%%%%%%%%%%%%
%.....o%..%%.%
%%..ooo..o...%
%..%...%...%.%
%.%......%%..%
%.....%......%
%%o....%o....%
%..%%.....%..%
%o%...%...%..%
%.%.....G.%..%
%.%........%.%
%...%G%%...%.%
%%.......%.%%%
%.G%.%.......%
%..P%..%%....%
%%%%%%%%%%%%%%
