%%%%%%%%%%%%%%%%
%. .  % %%G ...%
% ..P .%...% ..%
%G.  .......%  %
%.. .....%.. ..%
%  . %... %. . %
%%. ...........%
%%%%%%%%%%%%%%%%
