%%%%%%%%%%%%%%%%%%%
%    .. .  .... . %
%.. . .......% .  %
%%...% ....  .. . %
%... % .....%%.   %
%... ...  . ..  . %
%. .  ...... . . .%
%. ...........%%  %
%............ .P%.%
%..........%.%..% %
% ..%..  ........ %
%. ... .G.... .%..%
%... .......%... .%
%%%%%%%%%%%%%%%%%%%
