%%%%%%%%%%%%%%%
%...G.... ..% %
% ....%.....  %
%....P ..% .. %
%.%...  . ..%.%
%..... .%.%. %%
%....... %.%  %
%% ..%.%......%
%%%%%%%%%%%%%%%
