%%%%%%%%%%%%%%%%%%%
%......  . . .....%
%.... ............%
%.......% ..%G.. .%
% .% .  PG....%.%.%
%.  %.. ..%.. ..%.%
%.. ....%. .......%
%. %...% .........%
%... ..%.. .......%
%%.. ..  .%. .....%
%%%%%%%%%%%%%%%%%%%
