%%%%%%%%%%%%%%%%%%%%
%.P.... %..  %...%%%
%. . ... ....%.. ..%
%.......G.%.% ... G%
%...    ...........%
%........ . .G%. ..%
% .. %....... .....%
%. .. .%.... .. ...%
%%%%%%%%%%%%%%%%%%%%
