%%%%%%%%%%%%%%%%%
%.  .. .. ......%
% . . .  .. ....%
%.......  .. ...%
%.. ..%.%..%....%
%.. ..P. ..G   .%
% .....  ..... .%
%........% .. .%%
%. . ........ . %
%........  .....%
%%%%%%%%%%%%%%%%%
