%%%%%%%%%%%%%%%%%
%. .G... ...%...%
%.. ............%
%.. ......... . %
%...........P. .%
%.....%...... %.%
%. ...%...G.....%
%..%....... .. .%
%..%...%.. ..  .%
%.... G. .... ..%
%.. ....% . %...%
%%%%%%%%%%%%%%%%%
