%%%%%%%%%%%%%%%
% %%% ........%
%...  ...%...G%
%...P.% ......%
%.. %.. .  ...%
%.%.. ........%
%...G.....%..%%
% ...... %.. .%
%%%%%%%%%%%%%%%
