%%%%%%%%%%%%%%%%%%
%.....G%.........%
%%  ...%%.%....%.%
% .... .... .G...%
%%. .......... ..%
%...%... %......%%
%......G...%.% ..%
%........... ..P.%
%%.......%.... ..%
%%%%%%%%%%%%%%%%%%
