%%%%%%%%%%%%%
%%........ .%
%... .......%
%...%%..  ..%
% ..........%
%.......P...%
% ..G. ....%%
%....%......%
% .......G..%
%....... G..%
% ...% %.%. %
%......... %%
%%%%%%%%%%%%%
