%%%%%%%%%%%%%
%...%.......%
%...%..%.. .%
%. P........%
%%..%....%..%
%.G..... G..%
% . ..   .. %
%%%%%%%%%%%%%
