%%%%%%%%%%%%%%%%%%%%
%   .%.%..  ....  .%
%.% .%  P.......% %%
%.....   . .  .. . %
% ......   .. .... %
%.. ...%..  %.. ...%
%.. ....  ...... G.%
%..... ........ .. %
%%%%%%%%%%%%%%%%%%%%
