%%%%%%%%%%%%%%%%%
%........ ...%..%
%%... . %....%..%
%..%... ........%
%.%..%..P...%...%
%....G..%.%.....%
%..%..% ....... %
%%%%%%%%%%%%%%%%%
