%%%%%%%%%%
%..%...%%%
%........%
%%.%.Go%.%
%.%%.....%
%......%.%
%....%...%
%.%....G.%
%.%......%
%.%.....%%
%.o......%
%%..%....%
%....P...%
%%%%%%%%%%
