%%%%%%%%%%
%....%..o%
%..%.o.%.%
%.......%%
%.%%...%.%
%%.....o.%
%%...%...%
%....P..%%
%.o.G....%
%.%.....%%
%%....%%%%
%....%..o%
%%%%%%%%%%
