%%%%%%%%%%%%%%%%
% .. . %. ...%.%
% %.%.% ... ...%
%%%. . .   ... %
%..% .%.... ..%%
% ...... ... ..%
% G... .. .... %
%..P...%. .G...%
%%%%%%%%%%%%%%%%
