%%%%%%%%%%%%%%
%...  . ..  .%
% .. .... ...%
%. ....%. . .%
%.  ... .. ..%
% ...... . G.%
%.......     %
% ..... . P..%
% . ..... ...%
%. . ..% G.. %
% %. . ..... %
% ...%. ...%.%
%.  .. .... .%
%.....%.. ..%%
%%%%%%%%%%%%%%
