%%%%%%%%%%%%%%%%%%%%
%..  ...%..%...P...%
%%... ..  . ..... .%
%.%..%..  G..%..%.%%
%. .. .... ..... .G%
% %.  .%.%    ..%..%
%.. .%..  ..% ... .%
%  . . ........ ...%
%..... . .. G...%  %
%%%%%%%%%%%%%%%%%%%%
