%%%%%%%%%%%%%%
%. ......% %.%
%...G. .  ...%
%.%....   ...%
% .....  ....%
%..% ... ....%
%...%.. ... P%
%.  .%.... . %
%.%   ...... %
%...... .. %.%
%... .. .. %.%
%%.. .... .% %
%%%%%%%%%%%%%%
