%%%%%%%%%%%%%%
%... ..%... %%
%............%
%.... .....%%%
%%...........%
%........... %
%.....    . .%
%. .. ... . .%
%. %. .......%
%. . . ...%.%%
%.....%%.%.. %
%%.. G.P%....%
%... .... .% %
%%%%%%%%%%%%%%
