%%%%%%%%%%%%%%%%%%%
%... .. .. ... ..G%
%...%...%.........%
%. .. .........G..%
% .%.%..... ... ..%
%..%......... ....%
%%...P..........%.%
%.....%% ... .... %
%....... .G%. . ..%
% .. ... ..... . .%
%.... ..%.........%
%%% % .......... .%
%... .. ..........%
%%%%%%%%%%%%%%%%%%%
