%%%%%%%%%%%%%%%%
%......%G....% %
% %.. .. %..  %%
%. ...   . .. P%
%.....%.... .. %
%.%............%
%. .... .......%
%%... ....  ..G%
%...  ......%. %
%..... % ..%  .%
%.. . .. ....  %
%..%..  .. ....%
%. ...G.. . . .%
%%%%%%%%%%%%%%%%
