%%%%%%%%%%%%%%
%P..G.. .. .G%
%.. ........G%
%%......%% ..%
%.%....%% ...%
%%%..%....%%.%
%.. .. .%%...%
%......%... %%
%%%%%%%%%%%%%%
