%%%%%%%%%%%%%%%%%%
%%.. ..   .  .. .%
% .  ...%. .. .  %
% P.G ... . . ...%
%.. . .     .%  %%
%.%...%...%. ...%%
%.... ...  ......%
%%   %..G  . ....%
%  ... . ..... ..%
%  %.. ...%..... %
%. ... ..........%
%%%%%%%%%%%%%%%%%%
