%%%%%%%%%%%%%%%%%%
%. .  % .... . ..%
%... P ... ...%..%
%....  G. .. .%. %
%. ...   ..  .. %%
%.... .... ..... %
%.....%. ..  G%..%
%%%%%%%%%%%%%%%%%%
