%%%%%%%%%%%%%%%%%%
%...... .. ... ..%
%..... ....%.....%
%   P.. ..%..... %
%.. ..... G... ..%
%.. .... .......%%
%....% .%......  %
%%. ......  .....%
%. ......%...... %
%....%. .....  . %
%%%%%%%%%%%%%%%%%%
