%%%%%%%%%%%%%%%%%%%%
%. .... ..%. ...  .%
%%......%.. .. ... %
%......... .... . .%
%G........P  ... .%%
% . . ...........%.%
%.... ..  ..% .....%
% .... .   .. .... %
% . ....  ...%...  %
% ... .  .. ... ...%
%%%%%%%%%%%%%%%%%%%%
