%%%%%%%%%%%%%%%
%.. .  .. .  .%
% . ....%   ..%
%%..  .%.... .%
% .... ....  .%
%.G.. . .  ...%
%. . %.... .%.%
%.%  . ... %..%
%..P .. ......%
%. ...%%.... .%
%%%%%%%%%%%%%%%
