%%%%%%%%%%%%%%%%%%%
%..% . . .....%. .%
%... ... .... ... %
%%. . ... P.. .. .%
% .. ... ......% .%
%. %%..G . ..... .%
%. ... . .. ..   .%
%   .....      ...%
%........  ...  ..%
%%%%%%%%%%%%%%%%%%%
