%%%%%%%%%%%%%%%%%%%
%.%.....  .. .....%
%. ..%......G. ...%
%. ... %....... ..%
%.....  ...   ....%
%.% ............%.%
%..... ... ...... %
%..  .....P ..... %
%.. ........  ....%
%......... ..... .%
%......%....... ..%
% %..  .G.%.......%
%.. ...... .......%
%%%%%%%%%%%%%%%%%%%
