%%%%%%%%
%...%.%%
%......%
%%...%.%
%..%%%.%
%%.....%
%%.....%
%...%..%
%.G%...%
%..%%..%
%.%...o%
%......%
%....P.%
%%%%%%%%
