%%%%%%%%%%%%%%%%%%
% ...%.. .  .. . %
%..  ... %.... . %
%.. ...%. .. .   %
%.......  .. .. .%
%.  . .   .......%
%..... . ......  %
% ...........  ..%
%   ...%. P ..  .%
%..  .  . .%... G%
%. . . ...   ... %
%...  ... .......%
% . ...%. ..     %
%%%%%%%%%%%%%%%%%%
