%%%%%%%%%%%%%%%%%%%
%  .. ... .... ...%
%. ........%.. %. %
%% . .... ......  %
%. P.....  . ....%%
% %..........  ..%%
% .. . ...  ..... %
%....... ...  ..  %
%.. . ........... %
%. ... .G . ......%
%. ....  .. . ... %
% .%. .. .  . .  %%
%%%%%%%%%%%%%%%%%%%
