%%%%%%%%%%%%%%%%%%
%G.. ......G .  .%
%  ...... ...%...%
%..P  .. %...  . %
%... .....  .%.. %
%........  ...%..%
%... ..G %... .. %
%%%%%%%%%%%%%%%%%%
