%%%%%%%%%%%%%%%%%%%
%... ...   %... ..%
% .. .G. .. P. ...%
%... . ......  %..%
%. . ... % .......%
%........... ..%..%
%. . .... .. ..  .%
%.. .. ......  ...%
%.%.  ....%.......%
% ...% %. . .%....%
%.% . .% .........%
%.. ... .G. .. .. %
%%%%%%%%%%%%%%%%%%%
