%%%%%%%%%%%%%%
%....G .. ...%
%%........G..%
%............%
%....... .. .%
%.  .%.......%
% . ...%%%% .%
%... ....... %
% ..G.....P..%
%%%%%%%%%%%%%%
