%%%%%%%%%%%%%%%%%%%%
% ....  ...%.......%
%....P.......G.....%
%... .  ...........%
%.......%...G%.. ..%
%. . ..%.... ..... %
%. ..... .... . .G %
%%...... .. ..... .%
%%%%%%%%%%%%%%%%%%%%
