%%%%%%%%%%%%%%%%%
% ........ .%%. %
%. ...... .. . .%
%. . %..% % ... %
%  .  ...%%..   %
%.    .. .......%
%.. ... .. .. ..%
%... ..%. GG.G. %
%....   .%. P...%
%.  ..... .  ...%
%  ..  ..%.  ...%
% ....  ...  ...%
%%%%%%%%%%%%%%%%%
