%%%%%%%%%%%%%%
%. .. .%  ...%
%G. ... P....%
%.%.%. %... .%
% .... . %...%
%.G. ........%
%........G...%
%%%%%%%%%%%%%%
