%%%%%%%%%%%%%%%%
% ..%...   ....%
% ..%%.. ......%
%.   .... %. ..%
%. .  ... .... %
%% ..... . .   %
%....% ...... .%
% .............%
%. %  .. ..  . %
% ....    % .  %
%..% ... ..  ..%
%...GP  . .... %
%. . ... . ....%
%%%%%%%%%%%%%%%%
