%%%%%%%%%%%%%
%%%. GP..  .%
%. ..%%... .%
% .%...%. ..%
%... .%.....%
%..  ...... %
%%. ... ... %
%%. .  ....%%
%%%%%%%%%%%%%
