%%%%%%%%%%%%%%%%%%
%.. ..%.G .   ...%
%P.% .%.  .% . . %
% ... %%.... . . %
%. .. ...... .. .%
%%... . .%. .. ..%
%... ...  ..  ...%
%.G.. ......%... %
%....  .  ... ...%
%%%%%%%%%%%%%%%%%%
