%%%%%%%%%%%%%%%%
%.% ... .  ....%
%... .. ..%....%
% ..  . .......%
%.....%...%...%%
% .... ..  ....%
% .  ...  %....%
%...P. .%. G ..%
%...  .%.......%
%..... .G % ...%
%. ...  ..... .%
%... . ...... .%
%...G.... . . .%
%............. %
%%%%%%%%%%%%%%%%
