%%%%%%%%%%%%%%%%%%
%..........%....%%
%................%
%.... ... ...% ..%
%%..%%.  ......% %
%.. G....%.......%
%.... ... .. .%..%
%.%....P...... ..%
%..... .....%....%
%... ..% ..%.....%
%%%%%%%%%%%%%%%%%%
