%%%%%%%%%%%%%%%%%
% . .. .........%
% ..G .. . ...  %
%.%P ... .%.....%
%........... ...%
%..... .. ... .%%
%. ....%. .. .. %
%.. ........ ...%
%.%........ ....%
%. ...... .%. .%%
%%%%%%%%%%%%%%%%%
