%%%%%%%%%%%%%%%%%%
%... ....... . ..%
% ... .....  ....%
% . ....... .. ..%
%...  . ...% . . %
%...  ...........%
%. . . %...%.  . %
%.% %.....%%.. ..%
%......P..  ...  %
%.... ...... ....%
% .%.. ..%.......%
%  ...   %......%%
%% .. . ....%..G.%
%%%%%%%%%%%%%%%%%%
