%%%%%%%%%%%%%
%. .....P. .%
%....... ...%
%......%. G %
%.....G.....%
%. ...G. ...%
% . . ......%
%... ...%...%
%........ ..%
%...........%
%%. ......  %
% . %.... .%%
%%%%%%%%%%%%%
