%%%%%%%%%%%%%
%.... ......%
%..  ...%.. %
%... ..... .%
%  ...... .%%
%G ........ %
%.% P.. ....%
%.    ..G   %
%  ..... .  %
%.  .. .... %
%...... .  .%
%% %. ..   .%
%   % . ....%
%. . .. ..  %
%%%%%%%%%%%%%
