%%%%%%%%%%%%%%%%%
%. ..%....%G.   %
%.G.....P... ...%
%.........%.....%
%. ..%.... ..%..%
% . ..%...  ....%
%% .. .  . ..  %%
%..... ....... .%
%%...%...%... ..%
%.. ...G.....% .%
%... ........  .%
%%.. . ..  .... %
%%%%%%%%%%%%%%%%%
