%%%%%%%%%%%%%%%%%%%%
%.......... ... ...%
%... ... .... . . .%
%. %. .. .  . .. ..%
%..... ..G%%. .%...%
%...%...... ... .  %
%%%... ........ ...%
%........ .......%.%
%....% ....... ....%
%...P...... . .%...%
%......... ... . ..%
%. ...........%  %.%
%  ... ..  ..... %.%
%%%%%%%%%%%%%%%%%%%%
