%%%%%%%%%%%%%%%%%%%%
%......  .. ..... .%
%... .  ....%.....P%
% . . %.. . .. ... %
%.%..G...... . .. .%
%....  %..... .. ..%
%. .%...  ......%. %
%%%%%%%%%%%%%%%%%%%%
