%%%%%%%%%%%%
%.o...%%...%
%..%..%o...%
%%.........%
%%...%.%.%.%
%.....%...P%
%.o.....%..%
%..%.%.....%
%.%........%
%...%.o..%.%
%o%%.%%....%
%..........%
%%.G..%.%..%
%%.........%
%.......o..%
%.%......%.%
%.....%%%..%
%.%........%
%%%%%%%%%%%%
