%%%%%%%%%%%%%%%%%%
%%.....%%%.......%
%.............%..%
% .....%.P.......%
%...% .. .%.. . .%
%.%...G.....%....%
%..%...... G.....%
%.......%%. .....%
%%%%%%%%%%%%%%%%%%
