%%%%%%%%%%%%%%%%%
% ....%....... .%
% . . .. .   .%.%
%. ..  ..... ...%
% .   . .....%..%
%... ... . ..  .%
% .P.....%....%.%
%. ... ... .. ..%
%..  .. ...  .G.%
% %...... ... ..%
%%%%%%%%%%%%%%%%%
