%%%%%%%%%%%%%%%%%%%
%.....  .G..... ..%
%........ . .% .  %
%... %. .....%..G.%
%.....%.G......%. %
%.P.....%.. .... .%
%....%%..... .....%
%.%....... ...... %
%%%%%%%%%%%%%%%%%%%
