%%%%%%%%%%%%%%%
%.........%.. %
% ..  %...%. .%
%G......%.... %
%......G.... .%
%... .%..G  .P%
%%. .%....... %
%..%.....%....%
%%%%%%%%%%%%%%%
