%%%%%%%%%%%%%%%%
%.......%......%
% ...%..... .G %
%..%.. . ..... %
%  ....  .... .%
%. ........ ...%
%.  ...........%
% %. . ......% %
% . .% .. .  G.%
%... %. P . ..G%
%%%%%%%%%%%%%%%%
