%%%%%%%%%%%%
%.%........%
%%..%%.%..%%
%...%...%%.%
%%.o%...o..%
%.%.%......%
%..%Go...P.%
%..%%%....%%
%..%G..%%..%
%.%.%.%o.%.%
%%....%%.%%%
%....%..%%%%
%%%%%%%%%%%%
