%%%%%%%%%%%%%%%%%%%%
%. . %. ........ ..%
%.%.......P.  . . .%
%.........%  .. ...%
%   %......  ......%
%.... ...  ....%...%
%.  . ............ %
%.. ... G%% . .....%
%..... . G . ... .%%
%...... .. . .% ...%
% .%.... ..........%
%  . ..%. .........%
%%%%%%%%%%%%%%%%%%%%
