%%%%%%%%%%%%%%
%%..%. %.... %
%. .. %. ....%
%... ...  . .%
%. P... .....%
%.....%.% . .%
%. ..% %G....%
%. . ....  ..%
%... .. G .. %
%%%%%%%%%%%%%%
