%%%%%%%%%%%%%%%%%%
%....% .G . .... %
%.  .%.... %.%...%
%. ...%  . .. .. %
%.. .G .....   ..%
%..  . ...    . .%
%....%... ..... .%
%...  % . .%... .%
% .G.   . ... .. %
%  ..... .   %. .%
%......%%.. ... P%
%. .  .. ... ... %
%..%.... .  .....%
%..%....  .......%
%%%%%%%%%%%%%%%%%%
