%%%%%%%%%%%%%%%
%..o......%...%
%.......%...%%%
%%......%.....%
%..%%.%%o.%.%.%
%%....o.......%
%%.......%G...%
%o........%...%
%....%...%.G..%
%.%...........%
%.%..%.....%.%%
%%..%....%..%%%
%.%..%........%
%......%%P..%.%
%.%..........%%
%%%%%%%%%%%%%%%
