%%%%%%%%%%%%%%%%
%.... .%.%P....%
%..... ..  ..%.%
%.G...........%%
%.......... ...%
%. ..%..... . .%
%....G. .. ..%.%
%...%. ... ... %
%.........%.. .%
%.....%...%....%
%.%..  .......%%
%%%%%%%%%%%%%%%%
