%%%%%%%%%%%%%
%%.%........%
%%.o.%..o.o%%
%......%%..%%
%.%.......%.%
%%.%....G...%
%...%%.%%...%
%..%%.%.%...%
%%..P%%....%%
%...%..%%.%.%
%...........%
%o..........%
%..%..%o....%
%..%......G.%
%.........%.%
%.%.%......%%
%..%..%.....%
%..%........%
%%.....G%.%.%
%%%%%%%%%%%%%
