%%%%%%%%%%%%%%
%  . ...     %
%  .. . ... .%
%...  %...  .%
% .   . . .%.%
%. .... ..G..%
% .% . . . ..%
%..... .... .%
%. . ..  . . %
%.. . .......%
% ......%... %
%... ...%.   %
%  .... G... %
%...........P%
%%%%%%%%%%%%%%
