%%%%%%%%%%%%
%.%%.....%.%
%......%%%.%
%.%%..%...%%
%.....o....%
%%.........%
%%%P..%.%.%%
%%.%...%..%%
%.%........%
%.o.%......%
%....o.....%
%...%..%...%
%.%....%G..%
%....G..%.%%
%%%%%%%%%%%%
