%%%%%%%%%%%%%%%%
%.... .. .G. ..%
% ... ......%..%
%. ... %..... .%
%..... .. .... %
%... %. ..... .%
%  ... ... ... %
%.. .P%%..... .%
%... %... .  ..%
%%%.  . .. . ..%
%.......    . .%
%..%. %. . ....%
% .... .  .. .G%
%%%%%%%%%%%%%%%%
