%%%%%%%%%%%%%%%%%%
%  .... . .. %..G%
%. .%P.. .%......%
%...%.. .% .  ...%
%..%...  G..  . .%
%G. .%.. .... .%%%
%. .%.. ..%....% %
%%%%%%%%%%%%%%%%%%
