%%%%%%%%%%%%%%%%%
%. .............%
%..... ..%.%.. .%
%G. .%%....... .%
% ..............%
%..   ..........%
%.. .. ....... .%
%. .%... . . ...%
%.. . .... .....%
%. . ..G .% ....%
%..P.... ...%...%
%... ... . . ...%
%............ ..%
%.....%....  .. %
%%%%%%%%%%%%%%%%%
