%%%%%%%%%%%%%%
%%%..G.. ....%
%... . . ....%
% .... ..... %
%.. ....... .%
% .. ........%
%........% .G%
%.........P%.%
%..% %.... G.%
%%. ... ...% %
%%%%%%%%%%%%%%
