%%%%%%%%%%%%%%
%..  ..%.. . %
%  .% ....  .%
% .... .. ...%
%. %........G%
%. .....  ...%
%.. .........%
%.G.GP. ...%.%
%% ..... %...%
%.. ... .. ..%
%%%%%%%%%%%%%%
