%%%%%%%%%%%%%
%...%.  ....%
%. .. ... G.%
%%...% .....%
%...... .. .%
%...........%
%. ..%..%.%P%
%....... . .%
%  .....%.G.%
%%%%%%%%%%%%%
