%%%%%%%%%%%%%%%%
%. . %.  ... . %
% ....%....%...%
%..........%%.%%
%....G.. ...%..%
% ...%. .. G%..%
%....  ........%
%....%%..... ..%
% % ........ ..%
%......... .. .%
%.. ..........P%
%.... .......%.%
%%%%%%%%%%%%%%%%
