%%%%%%%%%%%%%%%%
%%.%.......%...%
%..G... ..GG.. %
%..%.%...%. ...%
%..%.....%....P%
% ..%.%........%
%.....%....%. .%
%%%%%%%%%%%%%%%%
