%%%%%%%%%%%%%%%%%
%.. .  G..... ..%
%   ...   . ....%
%..... ..... . .%
%...%...P... ...%
%....... %  ....%
%...%.... . ....%
% .. ....... ...%
%.  .% ....%... %
%G... . ...... .%
% ...   .  .%.  %
%..... ... . .. %
% .... .... .  .%
%%%%%%%%%%%%%%%%%
