%%%%%%%%
%.%.%%.%
%....%.%
%....%.%
%..PG.%%
%.%%.%.%
%%%..%.%
%%.%.%.%
%...%.o%
%..%...%
%.....%%
%.%.%..%
%.....%%
%%...%.%
%.%%%..%
%......%
%.%%..%%
%..%...%
%%%%%%%%
