%%%%%%%%%%%%%
%%   ..... .%
%%%  %.. . .%
%G  .%...%.P%
% ... . % %.%
%... .. . ..%
%.....GG.. .%
%.... ..  ..%
%..%.... . .%
%%%%%%%%%%%%%
