%%%%%%%%%%%%%%%%%%%
% ... .  ..  .%. .%
% . . . ...  ..  .%
% .%..  .  .. ....%
%  .. ..%...  .. .%
%%.G.. . .. ... ..%
%...%.... ...% .. %
%  % . .. . .  ...%
%... .  . ... ....%
% .... .G.P ..... %
%  .....   .. .. .%
%%%%%%%%%%%%%%%%%%%
