%%%%%%%%%%%%%%%%%%%
%.%.. ...  .......%
% % . . ..........%
%..%...%.%. .. ..P%
%...%.......... ..%
%%... ..... ....G.%
%....%......%. ...%
%............ .. .%
%.%......% .......%
%..%..... ...%... %
%%%%%%%%%%%%%%%%%%%
