%%%%%%%%%%%%%%%%%%%%
%G%.P ....%......%.%
%  . .  ......%..% %
%..%....... ..% .%.%
%. .. ......... .. %
%....... ....  ....%
% . ............ . %
%......%..... .... %
%..  ...... .  ... %
%.............. . .%
%%%%%%%%%%%%%%%%%%%%
