%%%%%%%%%%%%%
%..%.... %..%
%. ..G ....G%
%.%%.P.. ...%
%. .. %..%. %
%...G... ..%%
%. ... ...%%%
%.......  ..%
% ........ .%
%%...... ...%
%%%%%%%%%%%%%
