%%%%%%%%%
%...%%..%
%.....%.%
%.%.....%
%....%..%
%...%...%
%....o..%
%..G.o%.%
%....%..%
%o%.....%
%...%o.G%
%..P.o..%
%.%%.o.%%
%.....%.%
%%%%%%%%%
