%%%%%%%%%%%%%%%%%%
%...... .........%
% G....%. .......%
%.... ...........%
% .  ........%...%
%.. ...%.%...  ..%
%.....%..% .... .%
%.. .. %.........%
%. ...P........ .%
%.....%.. .. ....%
%.. ..%..... ....%
%.  %.......%....%
% .%...  ........%
%...%. .... .....%
%%%%%%%%%%%%%%%%%%
