%%%%%%%%%%
%%.......%
%........%
%.%...%%.%
%.......%%
%......%.%
%......%.%
%%....%.G%
%..%...P.%
%....%...%
%...%....%
%.o%.....%
%..%G.%..%
%%%%%%%%%%
