%%%%%%%%%%%%%
%.%....P.%..%
%...........%
%.. G ......%
%... .%.. .G%
% ....%... .%
%  . .... ..%
%..%..%  ..G%
%...%...% ..%
%....%..... %
%%   ......%%
%... ... ...%
%....     ..%
%......  . .%
%%%%%%%%%%%%%
