%%%%%%%%%%%%
%........o%%
%.%%..%.o.%%
%...%...%..%
%.%....%...%
%.........%%
%..%%..%...%
%%o%o%.....%
%..G%......%
%..P.o.....%
%.%%.%..%..%
%..%....o%.%
%..o.%.%o..%
%.%.%...%.%%
%..%%....%%%
%....%..o..%
%......%.G%%
%....%.%...%
%%%%%%%%%%%%
