%%%%%%%%%%%%%
%.  ..%....%%
%.....G....%%
%.... ......%
%..% .... ..%
%%. %... ..%%
%...%..G...%%
%P..%. .%%..%
%%%%%%%%%%%%%
