%%%%%%%%%%%%%%%%%%
% ......G. %%%.%.%
%.... ... %.. .G.%
%.%. %%. ...... .%
%.......%...G. ..%
%........%%......%
%. .%..%. .. ....%
%.. ...... ..... %
%....%...... .P..%
%. ..............%
%%%%%%%%%%%%%%%%%%
