%%%%%%%%%%%%%%%
%.. .%%..P....%
% .%..........%
%.... %.. ....%
%. ..  ..... .%
%% .. .. %..%.%
%.. . %.. ....%
%G %.G.%.%... %
%....... .. ..%
%. ... .G... .%
% ...........%%
%%%%%%%%%%%%%%%
