%%%%%%%%%%%%%%%%%%%
%..G.....%%...%.G.%
% ....... ..%.....%
%%.. .%....  ..%. %
%.........  ......%
%...... ... ......%
%.%.. ....%. .....%
%....... . . %..G.%
% .  ..%.%% .. P..%
%%%%%%%%%%%%%%%%%%%
