%%%%%%%%%%%%%%%%
%... ....  ... %
%  . ...%G... .%
%   . . ... ...%
%.. . . .......%
%..... %. G.   %
% ..  ....G..%.%
% ..% .........%
%  ..  ......%.%
% .. ....... ..%
% . ... .....  %
%......% .%....%
%%...  ...P  ..%
%  ...%%... ...%
%%%%%%%%%%%%%%%%
