%%%%%%%%%%%%%%
% .... .. ...%
%..  .. . ...%
%..GG..... ..%
%%. ..%...%..%
%......%.....%
%....... ....%
%. %... .....%
%...  %...%. %
% .. ........%
%..P%....... %
%... ........%
% .......%...%
%%%%%%%%%%%%%%
