%%%%%%%%%%%%%%%%%%%
%....... .. %...%%%
% .. ...  . .  ...%
%. .. .. %..%.....%
%... ..... %%. ...%
%... .%.... . . ..%
%... % .. . ......%
%. ... ...........%
%.. ......  .%. . %
%... .  .  .G.%. .%
%%...  .  . . ....%
%P .... .....  ...%
%%... %.%.. ..... %
%%%%%%%%%%%%%%%%%%%
